

     NO                ./textures/bluestone.xpm


SO ./textures/mossy.xpm


 WE     ./textures/purplestone.xpm
   EA                                                                                           ./textures/eagle.xpm
F 98,98,98



C     49,49,49



        1111111111111111111111111
        1000000000110000000000001
        1011000001110000000000001
        111000000000000000000000011111111
111111111011000011100000000000001
100000000011000001110111111111111
11110111111111011100000010001
11110111 11111011101010010001
11000000110101011100000010001
10020000000000001100000010001
10000000000000001101010010001
1100000111010101111101111000111
1111N111 1110101 101111010001
11111111 1111111 111111111111

