
F   76,153,0
     NO                ./textures/minecraft.xpm
      WE     ./textures/minecraft2.xpm

      SO ./textures/minecraft2.xpm









C     0,255,255
   EA                                             ./textures/minecraft.xpm
        1111111111111111111111111
        1000000000110000000000001
        10110000011100000N0000001
        1001000000000000000000001
111111111011000001110000000000001
100000000011000001110111111111111
1111000011111000000000000001
111100001   10000001010010001
110000001   10000000000010001
10002000111110001100000010001
10000000000000001101010010001
11111111111111111111111111111


