
F   49,106,31
     NO                ./textures/erba2.xpm
      WE     ./textures/erba1.xpm

      SO ./textures/erba2.xpm









C     166,228,237
   EA                                             ./textures/erba3.xpm
11111111111111111111111111111
10000000000000001000000000001
1011111110110000000000W000001
10100000001110111000000000011
11100111100100001111111111111
10100000100111100010000000001
10100111110000011110110111101
10100000001111000001110111101
10101011100001111100000111101
10101000010000000101111000101
10101111110111110100010010101
10100000010000011111110010011
10100111111110000000000010001
10101000000001111111111110101
10101000200000000100010000101
10001000000001110101010111111
11111111111110010001010000001
10100000100010001110011111101
10000100001000100000000000001
11111111111111111111111111111


