
F   94,91,78
     NO                ./textures/concrete.xpm
      WE     ./textures/fence.xpm

      SO ./textures/concrete.xpm









C     255,255,255
   EA                                             ./textures/fence.xpm
111111111111111111111111
100000000000000000000001
100000000000S00000000001
100000000000000000000001
100000000000000000000001
100000000000000000000001
100000000000000000000001
100000000000000000000001
100000000000000020000001
100000000000000000000001
100000000000000000000001
100000000000000000000001
111111111111111111111111


